000000000000000000000000
000000000000000000000000
000001111111111110000000
000001000000000010000000
000001000000000010004000
000001000003000010000000
004001000002000010000000
000001000000000010000000
000001000004000010000000
000001111111111110000000
000000000000000000000000
000000000000000000000000
