000000000000000000000000
000000000000000000000000
000001111111111110000000
000001000000000010000000
000001020000002010000000
000001000033000010000000
000001000033000010000000
000001020000002010000000
000001000000000010000000
000001111111111110000000
000000000000000000000000
000000000000000000000000
